##############
#S           #
#            #
#            #
##############
